糖尿病形成高脂血症原因	病因
病理性高血糖原因	病因
为啥会导致病理性高血糖	病因
高血糖怎么引起的	病因
糖尿病妊娠期肥胖原因	病因
糖尿病二型肥胖原因	病因
为何二型糖尿病会肥胖	病因
糖尿病患者低血糖原因	病因
为啥糖尿病患者老感冒	病因
糖尿病为什么会出现低血糖	病因
血糖波动大是怎么回事	病因
糖尿病患者为啥会造成失眠	病因
年轻人糖尿病是怎么引起的	病因
糖尿病是怎样引起的	病因
人为什么会得糖尿病	病因
糖尿病怎么引起的	病因
糖尿病牙龈出血是什么原因	病因
糖尿病腹泻的原因	病因
引起糖尿病的主要原因	病因
血糖高是怎样造成的	病因
糖尿病的病因有哪些	病因
哪些是糖尿病酮症酸中毒的诱因	病因
糖尿病为什么会引发白内障	病因
糖尿病人贫血是什么引起的	病因
糖尿病是什么引起的	病因
咋样才会得糖尿病	病因
2型糖尿病怎么引起的	病因
2型糖尿病怎么回事	病因
糖尿病又低血糖怎么回事	病因
咋样才会1型糖尿病又低血糖	病因
糖尿病引起低血糖原因	病因
糖尿病半夜低血糖成因	病因
糖尿病突然低血糖原因	病因
1型糖尿病低血糖成因	病因
糖尿病发生低血糖原因	病因
糖尿病餐前低血糖原因	病因
为何会得2型糖尿病	病因
糖尿病低血糖原因	病因
糖尿病什么原因导致低血糖	病因
糖尿病怎么引起的双目失明	病因
年轻人糖尿病怎么引起的	病因
瘦的人得糖尿病什么原因	病因
神经性糖尿病怎么回事	病因
1型糖尿病怎么引起的	病因
二型糖尿病怎么引起的	病因
早期糖尿病怎么引起的	病因
老人得糖尿病什么原因	病因
一般糖尿病怎么引起的	病因
糖尿病造成的原因	病因
糖尿病什么原因引起的	病因
糖尿病怎么引起的	病因
糖尿病腹泻的原因	病因
糖尿病性白内障的病因是什么	病因
糖尿病形成高脂血症原因	病因
糖尿病低血糖怎么回事	病因
糖尿病患者低血糖原因	病因
年轻人糖尿病是怎么引起的	病因
人为什么会得糖尿病	病因
引起糖尿病的因素有哪些	病因
糖尿病是怎样引起的	病因
人如何才会得糖尿病	病因
糖尿病的病因	病因
年轻人糖尿病发生和什么有关系	病因
为什么会得糖尿病	病因
糖尿病是怎么引起的	病因
引起糖尿病的主要原因	病因
2型糖尿病是什么因素引起的	病因
糖尿病的发生和什么有关系呢	病因
什么原因导致糖尿病足溃疡	病因
糖尿病的病因有哪些	病因
发生糖尿病皮肤感染原因是什么	病因
2型糖尿病的致病因是什么	病因
与糖尿病相关的易感因素	病因
应激性高血糖怎么治疗	治疗
的高血糖如何治疗方法	治疗
怎么治疗老年人高血糖	治疗
高血糖后遗症如何治疗	治疗
肝源性高血糖医治方法	治疗
产后高血糖怎么治疗啊	治疗
遗传性高血糖怎么治	治疗
严重高血糖怎么治疗	治疗
早期高血糖医治方法	治疗
新生儿高血糖怎么办	治疗
肥胖高血糖怎么治疗	治疗
餐后高血糖医治方法	治疗
如何治疗肾性高血糖	治疗
空腹高血糖怎么治疗	治疗
突发高血糖治疗方法	治疗
早期高血糖如何治疗	治疗
有哪些肝源性高血糖的治疗方式	治疗
有了高血糖咋治	治疗
肥胖高血糖的医治方式	治疗
老年高血糖如何医治	治疗
严重高血糖医治方式	治疗
治疗高血糖有哪些方法	治疗
高血糖如何治疗	治疗
高血糖怎么治	治疗
2型糖尿病高血糖怎么办	治疗
有糖尿病和高血压怎么治	治疗
糖尿病高血糖怎么治	治疗
糖尿病足怎么治疗	治疗
糖尿病咋治	治疗
如何治疗轻微糖尿病	治疗
治疗糖尿病方法	治疗
如何正确治疗高血糖	治疗
血糖偏高怎样治疗	治疗
血糖高疗法	治疗
高血糖的治疗方法	治疗
治疗尿糖病方法	治疗
高血糖了，咋办呀	治疗
患上糖尿病足病怎么治	治疗
糖尿病足的治疗有哪些	治疗
糖尿病足应该怎么办	治疗
糖尿病足的治疗方法	治疗
糖尿病足治疗有哪些方法	治疗
糖尿病足痛如何治疗	治疗
糖尿病肾炎怎么治疗方法	治疗
肥胖引起的2型糖尿病如何治疗	治疗
中老年2型糖尿病怎么治疗	治疗
消瘦2型糖尿病怎么治疗	治疗
2型糖尿病怎么治疗	治疗
2型糖尿病疗法	治疗
1型糖尿病如何治疗	治疗
30岁1型糖尿病咋办	治疗
糖尿病并发甲亢怎么治疗	治疗
确诊1型糖尿病要咋办	治疗
综合型糖尿病咋治	治疗
新生儿糖尿病如何治疗	治疗
糖尿病合并甲亢怎么办	治疗
早期的糖尿病咋治	治疗
得2型糖尿病常规治疗方法	治疗
确诊糖尿病如何治疗	治疗
2型糖尿病如何治疗	治疗
顽固性糖尿病咋办	治疗
轻微糖尿病如何治疗	治疗
1型糖尿病如何治疗	治疗
年轻糖尿病如何治疗	治疗
重度糖尿病常规治疗方法	治疗
老年糖尿病如何治疗	治疗
患了糖尿病如何治疗	治疗
孩子有糖尿病咋办	治疗
妊桭糖尿病咋办	治疗
隐性糖尿病怎么办	治疗
严重糖尿病咋办	治疗
初期糖尿病怎么办	治疗
1型糖尿病怎么治	治疗
早期糖尿病如何治疗	治疗
产后糖尿病怎么办	治疗
糖尿病如何治疗方法	治疗
老人有糖尿病怎么办	治疗
年轻人糖尿病怎么办	治疗
2型糖尿病怎么治	治疗
1型糖尿病怎么办	治疗
糖尿病并发症怎么治疗	治疗
糖尿病并发症怎么办	治疗
2型糖尿病高血糖怎么办	治疗
糖尿病高血糖怎么治	治疗
严重高血糖怎么治	治疗
高血糖如何治愈	治疗
高血糖咋治	治疗
高血糖怎么治	治疗
56岁得了糖尿病了咋办	治疗
1型糖尿病患者怎么接受治疗？	治疗
怎样才能治疗糖尿病	治疗
2型糖尿病有哪些常规治疗方法	治疗
2型糖尿病怎么治疗	治疗
糖尿病可以用什么方法治疗	治疗
治疗糖尿病的最好药物是什么？	用药治疗
餐后血糖高吃什么药？	用药治疗
哪些药能治疗糖尿病肾病	用药治疗
降血糖药物有哪些	用药治疗
治疗糖尿病最好的药有哪些	用药治疗
糖尿病常用药有哪几种	用药治疗
控制血糖的药有哪些	用药治疗
糖尿病肾病吃什么药特别好	用药治疗
治疗糖尿病的药物	用药治疗
2型糖尿病吃什么药比较好	用药治疗
糖尿病用药都有哪些	用药治疗
有治疗糖尿病白内障的药物吗	用药治疗
降血糖药物有哪些	用药治疗
糖尿病便秘吃什么药好	用药治疗
糖尿病应该吃什么药	用药治疗
慢性病糖尿病能开什么药	用药治疗
糖尿病足，脚痛吃什么止痛药能缓解	用药治疗
一型糖尿病降糖药常见有哪些？	用药治疗
治疗二型糖尿病的药物	用药治疗
糖尿病药有哪些药名	用药治疗
哪种感冒药适合糖尿病	用药治疗
适合糖尿病人的感冒药	用药治疗
糖尿病严重便秘啥药好	用药治疗
2型糖尿病单药治疗的首选药物	用药治疗
糖尿病初期吃什么药	用药治疗
糖尿病人感冒吃什么感冒药	用药治疗
二型糖尿病首选药物	用药治疗
糖尿病吃什么药	用药治疗
糖尿病的用药	用药治疗
2型糖尿病用药	用药治疗
糖尿病西药有哪些	用药治疗
糖尿病什么药好	用药治疗
糖尿病吃的药	用药治疗
糖尿病治疗药	用药治疗
2型糖尿病药	用药治疗
糖尿病的药物	用药治疗
2型糖尿病药物	用药治疗
糖尿病降糖药	用药治疗
糖尿病吃药	用药治疗
糖尿病的药方	用药治疗
治糖尿病的药	用药治疗
好的糖尿病药	用药治疗
什么药治疗糖尿病	用药治疗
糖尿病的治疗药	用药治疗
糖尿病的药物治疗	用药治疗
糖尿病的药有哪些	用药治疗
糖尿病足吃什么药	用药治疗
治疗糖尿病的药有哪些	用药治疗
糖尿病药品有哪些	用药治疗
治疗糖尿病的药物	用药治疗
糖尿病药有哪些	用药治疗
2型糖尿病首选降糖药	用药治疗
使用胰岛素的注意事项	用药情况
胰岛素治疗的适应症	用药情况
胰岛素使用的注意事项	用药情况
糖尿病人打胰岛素还一天最多打多少	用药情况
糖尿病药饭前吃还是饭后吃	用药情况
糖尿病药饭前吃还是饭后吃	用药情况
糖尿病人打胰岛素还一天最多打多少	用药情况
二甲双胍只吃一次早晨还是晚上	用药情况
二甲双胍饭前吃还是饭后吃	用药情况
注射胰岛素有副作用吗？	用药情况
用糖苷酶抑制剂治糖尿病要注意啥	用药情况
糖尿病患者什么时候吃药好呢	用药情况
1型糖尿病如何用胰岛素治疗	用药情况
胰岛素能口服吗?	用药情况
二甲双胍的吃法是什么？	用药情况
二甲双胍的不良反应是什么？	用药情况
二甲双胍怎么吃	用药情况
高血糖症状的早期表现	症状
糖尿病并发症症状	症状
早期高血糖的反应是什么	症状
饭后高血糖的现象	症状
单纯高血糖的反应有哪些	症状
餐后高血糖的表现	症状
高血糖症状表现	症状
糖尿病的早期症状	症状
血糖高的早期症状	症状
血糖高有什么症状	症状
糖尿病足刚开始啥症状	症状
糖尿病有哪些症状表现	症状
女性糖尿病有什么反应	症状
青少年糖尿病有哪些反应	症状
糖尿病的症状有哪些	症状
早期糖尿病男性症状	症状
糖尿病有什么反应	症状
女性早期糖尿病的症状	症状
糖尿病的症状	症状
血糖高的早期症状	症状
血糖高是糖尿病吗	症状
血糖低的症状有哪些	症状
血糖高有什么症状	症状
糖尿病反应	症状
早期糖尿病男性症状	症状
糖尿病初期有什么反应	症状
早期糖尿病男性症状	症状
糖尿病的临床表现有哪些	症状
糖尿病足的表现有什么	症状
糖尿病足的症状	症状
血糖高的症状	症状
糖尿病并发症是什么症状	症状
糖尿病性白内障的症状是什么现象	症状
高血糖症状的早期表现	症状
糖尿病并发症的早期症状	症状
糖尿病高血糖症状	症状
饭后高血糖的表征	症状
单纯高血糖的表征	症状
餐后高血糖有什么反应	症状
2型糖尿病合并肥胖症状	症状
糖尿病有哪些症状表现	症状
男糖尿病的症状有哪些	症状
糖尿病有哪些症状	症状
糖尿病初期症状	症状
糖尿病并发症的症状	症状
血糖高有什么症状	症状
糖尿病的表征	症状
糖尿病有什么现象	症状
糖尿病的表现	症状
血糖低并发症的症状有哪些	症状
血糖高有什么症状	症状
糖尿病足的早期症状	症状
女性早期糖尿病的反应是什么	症状
糖尿病前期一般会出现哪些症状？	症状
得了糖尿病会有哪些症状？	症状
糖尿病会引发哪些症状	症状
糖尿病患者有什么表征	症状
糖尿病的初期症状具体有什么	症状
糖尿病是什么现象	症状
一型糖尿病有什么表现	症状
2型糖尿病的表征是什么	症状
老年人高血糖一起发生的病	并发症
高血糖并发症有哪些	并发症
高血糖一并发生的有哪些	并发症
糖尿病低血糖并发症	并发症
1型糖尿病一起出现的病症有哪些	并发症
1型糖尿病并发症有那些	并发症
爆发性1型糖尿病并发症	并发症
2型糖尿病并发症表现	并发症
严重1型糖尿病并发症	并发症
糖尿病并发症有那些	并发症
伴随1型糖尿病发生的病	并发症
2型糖尿病并发症	并发症
糖尿病一同出现有哪些	并发症
高血糖一起出现的病有哪些	并发症
糖尿病高血糖并发症	并发症
糖尿病一同发生的病有哪些	并发症
糖尿病的急性并发症有哪些	并发症
糖尿病一起发生的病有哪些	并发症
糖尿病伴随发生的病	并发症
伴随糖尿病一起发生的疾病是什么	并发症
糖尿病的急性并发症有哪些	并发症
糖尿病都有哪些并发症	并发症
什么是糖尿病的并发症	并发症
糖尿病的并发症有哪些	并发症
2型糖尿病的并发症有哪些	并发症
糖尿病并发症状	并发症
糖尿病慢性并发症有哪些？	并发症
糖尿病有什么并发症状	并发症
糖尿病的常见并发症	并发症
糖尿病2型一同出现的病	并发症
糖尿病并发症有哪些呢	并发症
糖尿病会引起哪些并发症呢	并发症
2型糖尿病并发症状	并发症
糖尿病的并发症哪些	并发症
什么是糖尿病并发症	并发症
糖尿病肾病并发症状	并发症
糖尿病一同发生的病有哪些	并发症
糖尿病并发症	并发症
糖尿病会遗传吗	遗传
妈妈有糖尿病会遗传吗	遗传
父亲有糖尿病会遗传给孩子吗	遗传
糖尿病遗传吗	遗传
糖尿病会遗传吗	遗传
糖尿病遗传吗	遗传
糖尿病遗传么	遗传
2型糖尿病会遗传给孩子吗	遗传
2型糖尿病会遗传吗	遗传
高血压糖尿病遗传吗	遗传
原发性糖尿病遗传吗	遗传
2糖尿病遗传因素	遗传
母亲糖尿病遗传吗	遗传
父亲是糖尿病遗传吗	遗传
高血压会遗传吗	遗传
糖尿病遗传几率有多大	遗传
父亲有糖尿病会遗传给孩子吗	遗传
糖尿病遗传吗	遗传
糖尿病会遗传吗	遗传
糖尿病遗传吗	遗传
糖尿病会遗传吗	遗传
糖尿病遗传吗	遗传
糖尿病是否与遗传相关	遗传
高血糖平时要注意什么	保健与护理
糖尿病的护理措施哪些	保健与护理
2型糖尿病注意事项	保健与护理
1型糖尿病注意事项	保健与护理
2型糖尿病注意事项	保健与护理
老年糖尿病注意事项	保健与护理
糖尿病的护理措施哪些	保健与护理
糖尿病应该禁忌什么	保健与护理
糖尿病注意事项	保健与护理
糖尿病病人如何护理？	保健与护理
糖尿病如何控制病情	保健与护理
糖尿病人如何降低血糖呢	保健与护理
糖尿病人该怎样控制血糖呢	保健与护理
糖尿病足要怎么护理	保健与护理
糖尿病足的护理怎么办	保健与护理
老年人糖尿病注意事项	保健与护理
男性糖尿病平时应注意哪些事项	保健与护理
前期糖尿病注意事项	保健与护理
肝性糖尿病平时应注意什么问题	保健与护理
怎样降低餐后血糖	保健与护理
空腹血糖高如何控制	保健与护理
如何把空腹血糖降下来	保健与护理
血糖高如何降糖	保健与护理
糖尿病和种族有关系吗	其它
有糖尿病家族史怀孕一定会患糖尿病吗	其它
抱团得糖尿病全是遗传的原因吗	其它
糖尿病用什么泡脚好	其它
糖尿病可以同房吗	其它
糖尿病人饭后多久运动	其它
糖尿病不能泡脚吗	其它
糖尿病同房注意事项	其它
糖尿病可以抽烟吗	其它
糖尿病能汗蒸吗	其它
糖尿病能喝酒吗抽烟吗	其它
糖尿病能拔牙吗	其它
糖尿病人饭后多久运动	其它
糖尿病患者要怎么运动？	其它
锻炼可以治疗糖尿病吗	其它
糖尿病人怎么选择保健品	其它
糖尿病人可以吃保健品吗	其它
为什么高血糖患者需要坚持运动	其它
糖尿病患者怎么跑步	其它
游泳能够缓解糖尿病吗	其它
减重必须控制运动和饮食吗	其它
减重手术后怎样保护身体	其它
适合尿糖尿病人的室内运动	其它
糖尿病患者洗澡的注意事项	其它
糖尿病患者运动后心慌怎么回事	其它
糖尿病可以吃苹果吗	其它
二型糖尿病能吃芒果吗	其它
车厘子高血压糖尿病的人能不能吃	其它
2型糖尿病人能吃虾吗	其它
请问糖尿病人可以吃羊肉吗	其它
糖尿病人能吃火锅吗	其它
糖尿病人晚上睡觉出汗是什么原因	其它
营养不良会不会导致糖尿病	其它
糖尿病人为什么爱尿路感染	其它
2型糖尿病什么原因是什么意思	其它
2型糖尿病并发症原因	其它
糖尿病造成的腿疼什么原因	其它
糖尿病并发症的原因	其它
糖尿病人晚上睡觉出汗是什么原因	其它
牛奶如何使儿童患I型糖尿病	其它
肌糖原不能直接补充血糖的原因	其它
压力大会引起糖尿病吗	其它
为什么年纪大容易得糖尿病	其它
糖尿病是因为吃糖太多导致的吗	其它
糖尿病高血脂是饮食不当造成的吗	其它
吃的太多会引发糖尿病吗	其它
反式脂肪酸会导致糖尿病吗	其它
饮食中多糖会导致糖尿病吗	其它
缺铬是不是容易得糖尿病呢	其它
糖尿病会引起胆囊炎吗	其它
贫血和血糖高有关系吗	其它
贫血的人会得糖尿病吗	其它
糖尿病和尿毒症有关系吗	其它
糖尿病患者治疗时会得抑郁症吗	其它
打胰岛素会发胖吗	其它
糖尿病遗传危害	其它
消渴丸的功效与副作用	其它
打胰岛素起包了怎么办	其它
胰岛素长效与短效区别	其它
刚发现糖尿病能治好吗	其它
糖尿病酮症能治好吗	其它
糖尿病需要住院吗	其它
二甲双胍和消渴丸区别	其它
糖尿病越来越瘦怎么办	其它
糖尿病肚子大怎么回事	其它
糖尿病全身浮肿怎么办	其它
糖尿病容易饿吗	其它
嘴巴感觉甜是糖尿病吗	其它
尿多是糖尿病吗	其它
糖尿病小便有泡沫吗	其它
糖尿病尿毒症前期症状	其它
糖尿病什么程度会烂脚	其它
糖尿病严重的症状	其它
糖尿病的尿是什么颜色	其它
什么样的口干是糖尿病	其它
苹果能降血糖吗	其它
糖尿病小便特点	其它
糖尿病会身上痒吗	其它
血糖高会不会引起营养不良	其它
有糖尿病的人会不会营养不良	其它
阴茎皮反复裂口疼与糖尿病有关吗	其它
糖尿病尿频是什么症状	其它
糖尿病拔牙出血怎么办	其它
老人糖尿病尿血是怎么回事	其它
1型糖尿病并发症症状	其它
1型糖尿病并发症症状	其它
糖尿病并发症的症状	其它
高血糖并发症的症状	其它
高血糖并发症症状	其它
糖尿病的尿是什么颜色	其它
糖尿病人变瘦是晚期吗	其它
糖尿病体重持续下降怎么办	其它
什么样的口干是糖尿病	其它
尿液发粘是糖尿病吗	其它
糖尿病人出汗危险吗	其它
糖尿病人腰疼怎么回事	其它
尿是甜的就是糖尿病吗	其它
糖尿病的早期症状青少年	其它
胰岛素正常血糖高是糖尿病吗	其它
糖尿病肚子大怎么回事	其它
糖尿病全身浮肿怎么办	其它
糖尿病容易饿吗	其它
视力差是糖尿病的早期症状吗	其它
糖尿病会使人产生空腹感吗	其它
1型糖尿病早期警告信号是什么	其它
糖尿病能不能引起腹泻	其它
糖尿病人支架术后服哪些药	其它
糖尿病人并发症能治好吗	其它
糖尿病并发症的护理	其它
糖尿病并发症预防	其它
糖尿病并发症如何治疗	其它
糖尿病并发症怎么治疗	其它
牙疼是糖尿病并发症吗	其它
一型糖尿病并发症时间	其它
糖尿病并发症怎么查	其它
糖尿病并发症的早期是否能治好吗	其它
糖尿病并发症该如何治疗	其它
糖尿病腿疼是并发症吗	其它
糖尿病并发症能恢复吗	其它
